#######################################
#######################################
## #       #       #     #         # ##
## # ##### # ### ##### ### ### ### # ##
##       #   # #           # # #   # ##
###### # ##### #### ## # # # # ##### ##
##   # #       #     # # # # #     # ##
## # ####### # # ##### ### # ##### # ##
## #       # # #   #     #     #   # ##
## ####### ### ### # ### ##### # ### ##
##     #   # #   # #   #     # #     ##
## ### ### # # #   ##### # # # # ######
##   #   # # #   #   #   # # #   #   ##
######## # # # ##### # ### # ### ### ##
##     # #     #   # #   # #   #     ##
## ### # ##### ### # ### ### ####### ##
## #   #     #     #   # # #       # ##
## # ##### # # # ##### # # # ##### # ##
## #       # # # #     #       # #   ##
## ##### # # # ### ##### ##### # ######
## #   # # #     #     # #   #       ##
## # ### ### ### ##### ### # ##### # ##
## #         #     #       #       # ##
#######################################
#######################################